0;0;0;0;0;0;50;1;0;1
1;1;1;1;0;1;1;1;1;1
1;1;1;0;0;0;1;1;1;1
2;2;2;2;1;0;0;1;0;1
2;2;2;2;1;0;0;1;1;1
1;1;1;1;0;0;5;1;0;0
1;1;1;0;0;0;1;1;1;1
1;3;3;1;0;0;0;1;0;0;0
1;1;3;1;0;0;0;1;0;0
0;1;1;1;0;1;0;1;0;0
0;0;0;0;0;1;0;0;0;0
4